11111111111111111111111111111111111111111111111111111111111111
1001000C000C00000000000000000000000000000000000000000000000001
10000111110000000000000000000000000000000000000000000000000001
1P0011E0000000000000000000000000000000000000000000000000000001
10000000000000000000000000000000000000000000000000000000000001
10000000000000000000000000000000000000000000000000000000000001
10000000000000000000000000000000000000000000000000000000000001
10000000000000000000000000000000000000000000000000000000000001
10000000000000000000000000000000000000000000000000000000000001
10000000000000000000000000000000000000000000000000000000000001
10000000000000000000000000000000000000000000000000000000000001
100000000000000000000000000000000000000000000000000000000000C1
11111111111111111111111111111111111111111111111111111111111111