1111111111111111111111111
1000000000P0C0C0000000E11
1111111111111111111111111