11111111111111111111111111111111111111111111111111111111111111
1000000C000C000P0000000000000000000000000E000000000C0000C00001
11111111111111111111111111111111111111111111111111111111111111
